WWWWWWWWWW
WOOOOOOOOW
WOOOWOOOOW
WOOOOOWOOW
WWWWOWOOWW
WOOOOOWOOW
WOOOWOOOOW
WOOOOOOOOW
WWWWWWWWWW
